9 12 80
000000000000
010111111100
014102102100
010101001110
010201141110
011103111410
012114111110
010010110010
000000000000