0 0 0 0 0 0 0 8 8 8 0 0 0 0
0 0 0 0 0 0 0 8 2 8 0 0 0 0
0 0 0 0 0 0 0 8 0 8 0 0 0 0
0 0 0 0 0 0 0 8 1 8 8 8 8 8
0 0 0 0 8 8 8 8 0 4 1 0 2 8
0 0 0 0 8 2 0 1 0 0 8 8 8 8
0 0 0 0 8 8 8 8 8 1 8 0 0 0
0 0 0 0 0 0 0 0 8 0 8 0 0 0
0 0 0 0 0 0 0 0 8 2 8 0 0 0
0 0 0 0 0 0 0 0 8 8 8 0 0 0

0 0 0 0 0 0 0 0 0 0 0 0 0 0
0 0 0 0 0 0 0 0 0 0 0 0 0 0
0 0 0 0 0 0 8 8 8 0 0 0 0 0
0 0 0 8 8 8 8 2 8 0 0 0 0 0
0 0 0 8 6 1 0 1 8 0 0 0 0 0
0 0 0 8 8 0 0 0 8 0 0 0 0 0
0 0 0 0 8 8 8 8 8 0 0 0 0 0
0 0 0 0 0 0 0 0 0 0 0 0 0 0
0 0 0 0 0 0 0 0 0 0 0 0 0 0
0 0 0 0 0 0 0 0 0 0 0 0 0 0

0 0 0 0 0 0 0 0 0 0 0 0 0 0
0 0 0 0 8 8 8 0 0 0 0 0 0 0
0 0 0 0 8 2 8 8 8 8 0 0 0 0
0 0 0 0 8 0 4 0 0 8 0 0 0 0
0 0 0 0 8 0 8 1 1 8 0 0 0 0
0 8 8 8 8 1 8 0 0 8 0 0 0 0
0 8 2 0 0 0 0 1 0 8 0 0 0 0
0 8 8 8 8 8 8 2 2 8 0 0 0 0
0 0 0 0 0 0 8 8 8 8 0 0 0 0
0 0 0 0 0 0 0 0 0 0 0 0 0 0

0 0 0 0 0 0 0 0 0 0 0 0 0 0
0 0 0 0 0 0 0 0 0 0 0 0 0 0
0 0 8 8 8 8 0 0 0 0 0 0 0 0
0 0 8 0 2 8 0 0 0 0 0 0 0 0
0 0 8 0 0 8 8 8 0 0 0 0 0 0
0 0 8 3 0 0 0 8 0 0 0 0 0 0
0 0 8 0 0 1 0 8 0 0 0 0 0 0
0 0 8 0 4 8 8 8 0 0 0 0 0 0
0 0 8 8 8 8 0 0 0 0 0 0 0 0
0 0 0 0 0 0 0 0 0 0 0 0 0 0

0 0 0 0 0 0 0 0 0 0 0 0 0 0
0 0 0 0 0 0 0 0 0 0 0 0 0 0
0 0 0 0 0 8 8 8 8 0 0 0 0 0
0 0 8 8 8 8 0 0 8 0 0 0 0 0
0 0 8 0 1 2 1 0 8 8 0 0 0 0
0 0 8 4 0 1 0 1 2 8 0 0 0 0
0 0 8 8 8 0 2 2 8 8 0 0 0 0
0 0 0 0 8 0 0 8 8 0 0 0 0 0
0 0 0 0 8 8 8 8 0 0 0 0 0 0
0 0 0 0 0 0 0 0 0 0 0 0 0 0

0 0 0 0 0 0 0 0 0 0 0 0 0 0
0 0 8 8 8 8 8 8 8 0 0 0 0 0
0 0 8 4 2 8 0 0 8 0 0 0 0 0
0 0 8 0 0 1 0 0 8 0 0 0 0 0
0 0 8 8 0 8 8 0 8 8 0 0 0 0
0 0 0 8 0 8 8 0 0 8 0 0 0 0
0 0 0 8 2 0 1 0 0 8 0 0 0 0
0 0 0 8 0 0 8 0 0 8 0 0 0 0
0 0 0 8 8 8 8 8 8 8 0 0 0 0
0 0 0 0 0 0 0 0 0 0 0 0 0 0

0 0 0 0 0 0 0 0 0 0 0 0 0 0
0 0 0 0 0 0 0 0 0 0 0 0 0 0
0 0 0 8 8 8 8 8 0 0 0 0 0 0
0 0 0 8 0 0 0 8 0 0 0 0 0 0
0 0 0 8 0 1 2 8 8 8 0 0 0 0
0 0 0 8 8 6 1 0 0 8 0 0 0 0
0 0 8 8 8 1 2 8 0 8 0 0 0 0
0 0 8 0 0 0 0 0 0 8 0 0 0 0
0 0 8 0 0 0 8 8 8 8 0 0 0 0
0 0 8 8 8 8 8 0 0 0 0 0 0 0

0 0 0 0 0 0 0 0 0 0 0 0 0 0
0 0 0 8 8 8 8 8 0 0 0 0 0 0
0 0 0 8 0 0 0 8 0 0 0 0 0 0
0 0 8 8 1 8 0 8 8 8 0 0 0 0
0 0 8 6 1 0 2 1 0 8 0 0 0 0
0 0 8 8 0 2 0 0 0 8 0 0 0 0
0 0 0 8 0 0 0 8 8 8 0 0 0 0
0 0 0 8 8 8 8 8 0 0 0 0 0 0
0 0 0 0 0 0 0 0 0 0 0 0 0 0
0 0 0 0 0 0 0 0 0 0 0 0 0 0

0 0 0 0 0 0 0 0 0 0 0 0 0 0
0 0 8 8 8 8 8 8 0 0 0 0 0 0
0 0 8 0 0 0 0 8 0 0 0 0 0 0
0 0 8 0 1 1 1 8 8 0 0 0 0 0
0 0 8 0 0 8 2 2 8 8 8 0 0 0
0 0 8 8 0 0 2 3 0 0 8 0 0 0
0 0 0 8 0 4 0 0 0 0 8 0 0 0
0 0 0 8 8 8 8 8 8 8 8 0 0 0
0 0 0 0 0 0 0 0 0 0 0 0 0 0
0 0 0 0 0 0 0 0 0 0 0 0 0 0

0 0 0 0 0 0 0 0 0 0 0 0 0 0
0 0 0 8 8 8 8 8 8 8 0 0 0 0
0 0 0 8 0 0 0 0 0 8 8 0 0 0
0 0 0 8 0 1 0 0 4 0 8 0 0 0
0 0 0 8 1 1 8 8 1 0 8 0 0 0
0 0 0 8 0 1 2 8 0 0 8 0 0 0
0 0 0 8 2 2 2 0 2 8 8 0 0 0
0 0 0 8 8 8 8 8 8 8 0 0 0 0
0 0 0 0 0 0 0 0 0 0 0 0 0 0
0 0 0 0 0 0 0 0 0 0 0 0 0 0
